@@@@@@@@@@@@@@@@
@@@@@@@@@@@@@@@@
@@@@@@@@@@@@@@@@
@@@@@@@999999999
@@@@@@!sssssssss
@@@@@@!sohhhhhhh
@@@@@@!svsssssss
@@@@@@!svs^%%%%%
@@@@@@!svs#@@@@@
@@@@@@!svs#@@@@@
@@@@@@!svs#@@@@@
@@@@@@!svs#@@@@@