@@@@@@@@@@@@@@@@
@@@@@@@@@@@@@@@@
@@@@@@@@@@@@@@@@
9999999999999999
ssssssssssssssss
hhhhhhhhhhhhhhhh
ssssssssssssssss
%%%%%%%%%%%%%%%%
@@@@@@@@@@@@@@@@
@@@@@@@@@@@@@@@@
@@@@@@@@@@@@@@@@
@@@@@@@@@@@@@@@@