@@@@@@!svs#@@@@@
@@@@@@!svs#@@@@@
@@@@@@!svs#@@@@@
9999998svs#@@@@@
ssssssssvs#@@@@@
hhhhhhhh;s#@@@@@
ssssssssvs#@@@@@
%%%%%%$svs#@@@@@
@@@@@@!svs#@@@@@
@@@@@@!svs#@@@@@
@@@@@@!svs#@@@@@
@@@@@@!svs#@@@@@
