@@@@@@!svs#@@@@@
@@@@@@!svs#@@@@@
@@@@@@!svs#@@@@@
@@@@@@!svs#@@@@@
@@@@@@!svs099999
@@@@@@!svsssssss
@@@@@@!slhhhhhhh
@@@@@@!sssssssss
@@@@@@@%%%%%%%%%
@@@@@@@@@@@@@@@@
@@@@@@@@@@@@@@@@
@@@@@@@@@@@@@@@@
