@@@@@@!svs#@@@@@
@@@@@@!svs#@@@@@
@@@@@@!svs#@@@@@
@@@@@@!svs#@@@@@
9999998svs099999
ssssssssvsssssss
hhhhhhhhlhhhhhhh
ssssssssssssssss
%%%%%%%%%%%%%%%%
@@@@@@@@@@@@@@@@
@@@@@@@@@@@@@@@@
@@@@@@@@@@@@@@@@
