@@@@@@!svs#@@@@@
@@@@@@!svs#@@@@@
@@@@@@!svs#@@@@@
@@@@@@!svs#@@@@@
9999998svs#@@@@@
ssssssssvs#@@@@@
hhhhhhhh;s#@@@@@
ssssssssss#@@@@@
%%%%%%%%%%@@@@@@
@@@@@@@@@@@@@@@@
@@@@@@@@@@@@@@@@
@@@@@@@@@@@@@@@@
