@@@@@@@@@@@@@@@@
@@@@@@@@@@@@@@@@
@@@@@@@@@@@@@@@@
9999999999999999
ssssssssssssssss
hhhhhhhhohhhhhhh
ssssssssvsssssss
%%%%%%$svs^%%%%%
@@@@@@!svs#@@@@@
@@@@@@!svs#@@@@@
@@@@@@!svs#@@@@@
@@@@@@!svs#@@@@@
