@@@@@@!svs#@@@@@
@@@@@@!sss#@@@@@
@@@@@@!svs#@@@@@
9999998svs099999
ssssssssvsssssss
hhhhhhhhohhhhhhh
ssssssssvsssssss
%%%%%%$vvv^%%%%%
@@@@@@!svs#@@@@@
@@@@@@!vvv#@@@@@
@@@@@@!svs#@@@@@
@@@@@@!vvv#@@@@@
