@@@@@@!svs#@@@@@
@@@@@@!svs#@@@@@
@@@@@@!svs#@@@@@
@@@@@@!svs099999
@@@@@@!svsssssss
@@@@@@!sohhhhhhh
@@@@@@!svsssssss
@@@@@@!svs^%%%%%
@@@@@@!svs#@@@@@
@@@@@@!svs#@@@@@
@@@@@@!svs#@@@@@
@@@@@@!svs#@@@@@
