@@@@@@@@@@@@@@@@
@@@@@@@@@@@@@@@@
@@@@@@@@@@@@@@@@
9999999999@@@@@@
ssssssssss#@@@@@
hhhhhhhhps#@@@@@
ssssssssvs#@@@@@
%%%%%%$svs#@@@@@
@@@@@@!svs#@@@@@
@@@@@@!svs#@@@@@
@@@@@@!svs#@@@@@
@@@@@@!svs#@@@@@
