@@@@@@!svs#@@@@@
@@@@@@!svs#@@@@@
@@@@@@!svs#@@@@@
@@@@@@!svs#@@@@@
9999998svs#@@@@@
ssssssssvs#@@@@@
hhhhhhhhps#@@@@@
ssssssssvs#@@@@@
%%%%%%$svs#@@@@@
@@@@@@!svs#@@@@@
@@@@@@@ttt@@@@@@
@@@@@@!svs#@@@@@
